
4 AĞUSTOS
Bülent ECEVİT
«Nurlu istikbal» denen se-	dır olduğundan daha hesap- \
raba doğru pusulasız,   dolu	lı ve ahenkli yürütülmek şar:
dizgin koşuşun bir çöl   ka.	tiyle - durdurulabilirdi; fa- i
ranlığında    nefesi    tükenip	kat yalnız o frenleyici tedi|
büyük bir sarsıntıyla duru-	birlerle memleket ekonomi- ]
verdiği gün    üstünden    bir	sinin yeni bir hız    kazanıp :
yıl geçti.	1958de  düştüğü  çıkmazdan :
Geçimini alın teriyle    ka-	kurtuluş yoluna girmesi el1
zanan insanlar,   bugün, bir	bette beklenemezdi,
yıl öncekinden daha sıkı bir	Böyle tedbirler,    istihsali
darlık içinde. Yeni    gelişen	ve ihracatı arttırıcı, verimendüstri kollarından bir ço-	li, iyi hesaplanmış bir çalışğunda fabrikalar kapanmış	ma  programına bağlanmaveya kapanmak üzere.   Ka-	dıkça, elbette bir umut ışıpanan fabrikaları ham mad-	ğı  getiremezdi Halkın    tade ile besleyen köylü müşte-	hammülü, bir yıldır, bir yarisiz. Kapanan fabrikalarda	yın sonuna kadar gerilişi giçalışan işçiler işsiz.	bi gerildi; ama ileri fırlatıFiyatlar hâlâ «daha yük-	lacak ok zamanında hazırsek seviyede istikrarsa doğ-	lanmadıktan,  okun     hedefi
ru yükseliyor.	iyice hesaplanmadıktan son
Yatırımlarda ve istihsalde	ra, bu geriliş neye yarardı?
düşüş...  ihracatta     düşüş...	Bizi 4 Ağustos 1958'e getiArtan ancak fiyatlar ve borç.	ren, bu     iktidarın plân  ve
Bütün  bunların  sorumlu-	programı  kabul     edemiyen
lan da hâlâ halka «refah i-	zihniyeti, kabul etmek    zoçindesiniz» diyebilecek    ka-	randa kalsa bile hazırlayıp
dar, ya halktan habersiz ya	uygulayamıyan       davranışı
halkın ıstırabına karşı duy-	idi. Ayni zihniyet ve davragusuz.	niş bizi nasıl 4 Ağustos 1958'
•*•	de saplandığımız çıkmazdan
4 Ağustos 1958'deıı  itîba-	kurtarabilirdi?
ren, bize yardım eli uzatan	Tersine,    bu    çıkmazdan
dostların koştuğu    şartlara	milletçe  kurtulabilmemiz  öuyularak alman, para değeri	nünde en büyük engel, bizi
nin düşürülmesi, piyasaya az	o çıkmaza sokan kimselerin,
para sürülmesi, satın  alma	hiç değişmediği ve değişmegücünün   kısılması,  kredile-	yeceği görülen zihniyet    ve
riıı    daraltılması gibi fren»	davranışıdır,
leyici «istikrar tedb'rleri» i-	**»
le. memleket    ekonomisinin	Çıkmazdan  kurtulma   güdüştüğü çıkmazda büsbütün	cünü tonlavabilmek için, bir
ilerlemesi . o tedbirler bir yıl	(Sonu Sa. 5 Sü. 8 de]

